60 65
TTTTTTTTTTTTTTTTTTTTTTTTTTTTTTTTTTTTTTTTTTTTTTTTTTTTTTTTTTTT           
T..........................................................T
T..........................................................T
T..........................................................T
T..........................................................T
T..........................................................T
T..........................................................T
T..........................................................T
T..........................................................T
T..........................................................T
T..........................................................T
T..........................................................T
T..........................................................T
T..........................................................T
T..........................................................T
T..........................................................T
T..........................................................T
T..........................................................T
T..........................................................T
T..........................................................T
T..........................................................T
T..........................................................T
T..........................................................T
T..........................................................T
T..........................................................T
T..........................................................T
T..........................................................T
T..........................................................T
T..........................................................T
T..........................................................T
T..........................................................T
T..........................................................T
T..........................................................T
T..........................................................T
T..........................................................T
T..........................................................T
T............###########...................................T
T............#.........#...................................T
T............#.......p.#...................................T
T............#....######...................................T
T............#....#....#...................................T
T............#....#........................................T
T............#....#....#...................................T
T............#.........#...................................T
T............#....#....#...................................T
T............#....#....#...................................T
T............###########...................................T
T..........................................................T
T..........................................................T
T..........................................................T
T..........................................................T
T..........................................................T
T..........................................................T
T..........................................................T
T..........................................................T
T..........................................................T
T..........................................................T
T..........................................................T
T..........................................................T
T..........................................................T
TTTTTTTTTTTTTTTTTTTTTTTTTTTTTTTTTTTTTTTTTTTTTTTTTTTTTTTTTTTT
TTTT  TT TTTTTT TTTTTTTTT TT TTTTTT TTT TTTTTT TTTTTTTTTTTT
 TT   T T T T TT TTT         TT T T TT  TT T T T  TTT TT TTT